111111111111111111
101100100000011001
1E0010101001111111
100C00100001110001
10001100P0000000C1
111111111111111111
